
Men's Clothing (Las prendas masculinas)
el abrigo 	the coat
el lazo 	string tie
la agujeta 	the shoelace
el overol, el peto 	overalls
los calcetines 	socks 	la pajarita 	bow tie
el calzoncillo 	under shorts 	los pantalones 	trousers
la camisa 	shirt 	el sombrero 	the hat
la camiseta 	undershirt 	el suéter 	the sweater
la corbata 	tie 	el suspensorio 	athletic supporter
la gorbata 	the tie 	el traje 	suit
la gorra 	the ballcap 	los zapatos 	shoes

Women's Clothing (Las prendas femeninas)
el algodón 	the cotton 	la pijama 	the pajama(s)
la blusa 	blouse 	la pantaleta 	panties
la bolsa 	handbag 	la pantimedia 	pantyhose
el bustillo 	camisole
la cierre 	the zipper 	el refajo 	slip
el cinturón 	belt 	las sandalias 	sandals
la falda 	skirt 	el velcro 	the velcro
los guantes 	the gloves 	el vestido 	dress
las medias 	stockings 	los zapatos de tacón alto 	high heels
Plants and Animals

Plants (Las plantas)
el árbol 	tree 	la hoja 	leaf
el arbusto 	bush 	la margarita 	daisy
el botón 	bud 	la orquídea 	orchid
el bulbo 	bulb 	el tallo 	stem
el cactus 	cactus 	el tulipán 	tulip
la enredadera 	vine 	la violeta 	violet
la flor 	flower 	la rosa 	rose

Animals (Los animales)
la abeja 	bee 	la iguana 	iguana
el alacrán 	scorpion 	la jirafa 	giraffe
el alce 	moose 	la lagartija 	lizard
el águila 	eagle 	el león 	lion
la anguila 	eel 	la libélula 	dragonfly
la araña 	spider 	la llama 	llama
la ardilla 	squirrel 	el loro 	parrot
la ardillita 	chipmunk 	la mantis 	mantis
el armadillo 	armadillo 	la mariposa 	butterfly
el bisonte 	bison 	el mono 	monkey
el búho, la lechuza 	owl 	la mosca 	fly
el burro 	donkey 	el mosquito 	mosquito
el caballo 	horse 	el pájaro carpintero 	woodpecker
la cabra 	goat 	la paloma 	dove
el caimán 	alligator 	el perro 	dog
el camaleón 	chameleon 	el petirrojo 	robin
el cardenal 	cardinal 	el pez espada 	swordfish
la cebra 	zebra 	el oso 	bear
el cerdo 	hog 	la oveja 	sheep
el cocodrilo 	crocodile 	la rana 	frog
el colibrí 	hummingbird 	la rata 	rat
el colmillo 	tusk 	el ratón 	mouse
el conejo 	rabbit 	la raya 	stingray
el cisne 	swan 	el renacuajo 	tadpole
la cucaracha 	cockroach 	el rinoceronte 	rhinoceros
el cuerno 	antler 	el salmón 	salmon
el cuervo 	crow 	el saltamontes 	grasshopper
el elefante 	elephant 	el tiburón 	shark
el escarabajo 	beetle 	el tigre 	tiger
el gato 	cat 	la tortuga 	turtle
la gaviota 	seagull 	la trompa 	trunk
el gorrión 	sparrow 	la trucha 	trout
el grillo 	cricket 	la vaca 	cow
el gusano de seda 	caterpillar 	el venado 	deer
el halcón 	hawk 	la víbora 	snake
el hipopótamo 	hippopotamus 	el zorro 	fox
la hormiga 	ant 	el zancudo 	mosquito
Rooms, Buildings and Places

The Baby's Room (El cuarto del bebé)
el babero 	bib 	la cuna mecedora 	cradle
el biberón 	bottle 	el móvil 	mobile
los bloques 	blocks 	el oso de peluche 	teddy bear
el carrito 	stroller 	el pañal 	diaper
el chupador, el chupete 	pacifier 	la tetilla 	nipple
la cuna 	crib

The Bath (El baño)
la bañera 	bathtub 	la esponja 	sponge
el botiquín 	medicine cabinet 	el gorro de baño 	shower cap
la cañería 	the pipe 	el excusado 	toilet
el champú 	shampoo 	el jabón 	soap
el cortinero 	curtain rod 	la jabonera 	soap dish
el desagüe 	drain 	el lavamanos 	sink
la ducha 	shower 	la tina 	the bathtub
el espejo 	the mirror 	la toalla 	towel

The Kitchen (La cocina)
el abrelatas 	can opener 	el lavaplatos 	the dish washer
el brillo, el estropajo 	scouring pad 	la licuadora 	blender
la cacerola 	casserole dish 	la loza 	china
el caldero 	pot 	la mesa 	table
el candil 	chandelier 	la nevera 	refrigerator
el chinero, el aparador 	china cabinet 	la olla 	saucepan
el colador 	colander 	el plato 	plate
el congelador 	the freezer 	el pimentero 	pepper shaker
la cuchara 	knife 	el refrigerador 	the fridge
el destapador 	bottle opener 	el salero 	salt shaker
el escurridor 	dish drainer 	la sartén 	frying pan
la estufa 	stove 	la servilleta 	napkin
el fregadero 	sink 	la tapa 	lid
el gabinete 	cabinet 	el tenedor 	fork
el horno 	oven 	el tostador 	the toaster
el horno microondas 	microwave 	la vaporera 	steamer
la jarra 	pitcher 	el vaso 	glass
la latería 	canister

The Laundry Room (El cuarto de servicios)
la aspiradora 	vacuum 	la plancha 	iron
el calentador de agua 	the water heater 	el recogedor 	dustpan
la escoba 	broom 	la secadora 	dryer
la lavadora 	washing machine 	los trapos 	rags
la limpiadora 	mop

The Bedroom (El cuarto)
la cama 	the bed 	el despertador 	the alarm clock
la mesita de noche 	the nightstand 	las sábanas 	the sheets
la cómoda 	the dresser 	el armario 	the closet
la almohada 	the pillow 	el colgador 	the hanger
la cobija 	the blanket

The Living Room (La sala)
la escalera 	staircase 	el techo 	ceiling
el jarrón 	vase 	los muebles 	the furniture
la lámpara 	lamp 	la mesa 	the table
la mesita 	end table 	la cama 	the bed
la mesita central 	coffee table 	el sillón 	the armchair
la pared 	wall 	la silla 	the chair
la pintura 	painting 	el escritorio 	the desk
la repisa 	mantel 	el piano 	the piano
el sofá 	sofa 	el basurero 	the garbage can
el sillón 	recliner

The Workshop (El taller de trabajo)
los alicates 	pliers 	la llave inglesa, la llave 	wrench
la caja de herramientas 	toolbox 	el martillo 	hammer
la cinta métrica 	tape measure 	el serrucho de carpintero 	carpenter's saw
el destornillador 	screwdriver 	la sierra de calar 	coping saw
la escofina 	rasp 	la sierra para metales 	hacksaw
el formón 	chisel 	el tornillo 	clamp, vise, screw
la lima 	file

Airport (El aeropuerto)
el boleto 	ticket 	el guardia 	security guard
el bolso de mano 	carry-on 	la maleta 	suitcase
el detector de metales 	metal detector 	el porta ropa 	garment bag
el equipaje 	baggage

Restaurant (El restaurante)
la cuenta 	check 	la mesa 	table
el cocinero 	cook 	la mesera, la camarera 	waitress
el menú 	menu

Stores (Tiendas)
la agencia de viajes 	travel agency 	la pastelería 	cake shop
la carnicería 	butcher 	la peluquería 	hairdressers
la confitería 	sweet shop 	la pescadería 	fish shop
la gasolinera 	gas station 	la tienda de fotografía 	photo shop
los grandes almacenes 	department store 	el bolso 	the bag
la floristería 	flower shop 	la oferta 	the sale
la panadería 	bakery 	la venta de liquidación 	the clearance sale
la papelería 	stationers

The Beach (La playa)
las aletas 	flippers 	el mar 	sea
la arena 	sand 	la marea 	tide
el alga 	seaweed 	la onda 	the wave
el castillo de arena 	the sand castle 	la orilla 	the shore
la crema bronceadora 	sunscreen 	la toalla 	towel
la duna 	dune 	el traje de baño 	swimsuit
las gafas del sol 	sunglasses 	la sombrilla 	parasol
los lentes de sol 	the sunglasses

Downtown (El centro)
los apartamentos 	apartment building 	el letrero 	street sign
el ascensor 	elevator 	la oficina de correos 	post office
la banca 	bench 	el paradero de autobuses 	bus stop
el basurero 	trashcan 	el policía de tránsito 	traffic cop
el cruce 	intersection 	el recibidor 	lobby
el edificio 	building 	el semáforo 	traffic light
el edificio de oficinas 	office building 	la vía peatonal 	crosswalk
la esquina 	corner
Weather
el tornado 	the tornado 	calor 	hot
el huracán 	the hurricane 	la temperatura 	the temperature
el inundación de agua 	the flood 	el termómetro 	the thermometer
la lluvia 	the rain 	nebuloso 	foggy
la nieve 	the snow 	la neblina 	the fog
nublado 	cloudy 	ventoso 	windy
hace sol 	it's sunny 	hace viento 	it's windy
el sol 	the sun 	la humedad 	the humidity
frío 	cold 	la nube 	the cloud
Sports
tenis 	tennis 	jockey 	hockey
básquetbol 	basketball 	rugby 	rugby
golf 	golf 	ciclismo 	cycling
fútbol 	soccer 	críquet 	cricket
fútbol 	football 	equitación 	horseback riding
voleibol 	americano volleyball 	natación 	swimming
ping pong 	ping pong 	el partido 	the game (sporting event)
bádminton 	badminton 	el equipo 	the team
béisbol 	baseball
Music
los géneros 	the genres 	el piano 	the piano
la guitarra 	the guitar 	el director 	the conductor
los tambores 	the drums 	la letra 	the lyrics
la trompeta 	the trumpet 	el órgano 	the organ
Colors
rojo 	red 	anaranjado 	orange
azul 	blue 	rosa 	pink
amarillo 	yellow 	marrón 	brown
verde 	green 	negro 	black
violeta 	violet 	blanco 	white
morado 	purple
Food
el limón 	the lemon 	el aperitivo 	the appetizer
la lima 	the lime 	el aguacate 	the avocado
los frijoles 	the beans 	la carnederes 	the beef
el tomate 	the tomato 	el desayuno 	the breakfast
la remolacha 	the beet 	la coliflor 	the cauliflower
el rábano 	the radish 	el apio 	the celery
la spalomitasdemaíz 	the popcorn 	el queso 	the cheese
la mantequilla 	the butter 	el pollo 	the chicken
la miel 	the honey 	el postre 	the dessert
la nuez 	the nut 	la cena 	the dinner
el maní 	the peanut 	el huevo 	the egg
la mermelada 	the jam 	el pescado 	the fish (cooked)
la jalea 	the jelly 	la hamburguesa 	the hamburger
la mantequilla de maní 	the peanut butter 	el hotdog 	the hotdog
el jugo 	the juice 	las papas fritas 	the french fries
el dulce 	the candy 	el almuerzo 	the lunch
la mayonesa 	the mayonnaise 	la lechuga 	the lettuce
el kéchup 	the ketchup 	el plato principal 	the main dish
la mostaza 	the mustard 	la leche 	the milk
la piña 	the pineapple 	el puerco 	the pork
la banana 	the banana 	las papas 	the potatoes
el durazno 	the peach 	la ensalada 	the salad
el albaricoque 	the apricot 	el sándwich 	the sandwich
la pera 	the pear 	la sopa 	the soup
la uva 	the grape 	el azúcar 	the sugar
la pasa 	the raisin 	el pavo 	the turkey
la harina 	the flour 	el agua 	the water
la comida 	the food 	el helado 	ice-cream
Relations
la familia 	the family 	el suegro 	the father-in-law
la mamá 	the mom 	el novio 	the fiancé
el papá 	the dad 	el hijo 	the son
el hermano 	the brother 	la hija 	the daughter
la hermana 	the sister 	la nuera 	the daughter-in-law
la tía 	the aunt 	el yerno 	the son-in-law
el tío 	the uncle 	las relaciones 	the relationships
los abuelos 	the grandparents 	el amigo 	the friend
la abuela 	the grandma 	el novio 	the boy friend
el abuelo 	the grandpa 	el marido 	husband
los primos 	the cousins 	la esposa 	wife
el sobrino 	the nephew 	la madre 	the mother
el cuñado 	the brother-in-law 	el padre 	the father
la cuñada 	the sister-in-law 	la sobrina 	the niece
la suegra 	the mother-in-law
Car
el cofre 	the hood 	la gasolina 	the gas
las luces de lanteras 	the head lights 	el tanque 	the gas tank
las luces traseras 	the tail lights 	los limpiaparabrisas 	the wipers
el acelerador 	the gaspedal 	la transmisión automática 	the automatic transmission
los frenos 	the brakes 	la transmisión manual 	the manual transmission
la cajuela 	the trunk 	primera velocidad 	first gear
el motor 	the engine 	la palanca de velocidades 	the gearshift
el parabrisas 	the windshield 	la señal decambios 	the turn signal
la ventana 	the window 	el parachoques 	the bumper
la rueda 	the wheel 	la visera 	the visor
la llanta 	the tire 	el espejo retrovisor 	the rearview mirror
el eje 	the axel 	el gato 	the jack
el claxon 	the horn 	la llanta de repuesto 	the spare tire
el volante 	the steering wheel 	laquemacoco 	the sunroof
el chofer 	the driver 	el cinturón 	the seatbelt